R 800 800
NO ./tex_no.xpm
SO ./tex_so.xpm
WE ./tex_we.xpm
EA ./tex_ea.xpm

S ./sprite.xpm
F 220,100,0
C 225,30,0

11111111111111111111111111111111111111111111111111111111111111111111111111111111
10000000000000000000000000000000000000000000000000000000000000000000000000000001
1000E000000000000200000000000000000000000000000000000000000000000000000000200001
10001111111111111111100111111111111110011111111111111100111111111111111000000001
10001111111111111111100111111111111110011111111111111100111111111111111000000001
10000000000000000000000000000000000000000000000000000000000000000000000000000001
10000000000000000000000000000000000000000000020000000000000000000000000000000001
10001111111111111111100111111111111110011111111111111100111111111111111000000001
10001111111111111111100111111111111110011111111111111100111111111111111000000001
10000000000000000000000000000000000000000000000000000000000000000000000000010001
10000000000000000000000000000000000000000000000000000000000000000000000000000001
11110001111111111111111111111111111111111111111111111111111111111111111111111111
11110001
11111111