R 1280 720
NO ./tex_no.xpm
SO ./tex_so.xpm
WE ./tex_we.xpm
EA ./tex_ea.xpm

S ./sprite
F 220,100,0
C 225,30,0

11111111111111111111111111111111111111111111111111111111111111111111111111111111
10000000000000000000000000000000000000000000000000000000000000000000000000000001
10000000000000000000000000000000000000000000000000000000000000000000000000000001
10001111111111111111100111111111111110011111111111111100111111111111111000000001
10001111111111111111100111111111111110011111111111111100111111111111111000000001
10000000000000000000000000000000000000000000000000000000000000000000000000000001
1000000000000000000000000000000000000000000000000000000000000E000000000000000001
10001111111111111111100111111111111110011111111111111100111111111111111000000001
10001111111111111111100111111111111110011111111111111100111111111111111000000001
10000000000000000000000000000000000000000000000000000000000000000000000000010001
10000000000000000000000000000000000000000000000000000000000000000000000000000001
11111111111111111111111111111111111111111111111111111111111111111111111111111111
