R 1280 720
NO ./texture_no
SO ./texture_so
WE ./texture_we
EA ./texture_ea

S ./sprite
F 220,100,0
C 225,30,0

111111111111111111
100000000000000001
101001111110000001
100001111110000001
100000000000000001
100000000000000001
100000000000000001
100000000000000001
100000000000000001
100000000000000001
100011100111000001
100011100111000001
100011100111000001
100000000000000001
100000000000000001
100000000000000001
100000000000000001
111111111111111111
