R 1024 1024
NO ./texture_no
SO ./texture_so
WE ./texture_we
EA ./texture_ea

S ./sprite
F 220,100,0
C 225,30,0

1111111111111111
1000000000000001
1010011111100001
1000011111100001
1000011111100001
1000011111100001
1000011111100001
1000000000000001
1000000000000001
1000000000000001
1000111111110001
1000111111110001
1000111111110001
1000000000000001
1000000000000001
1111111111111111
