R 1280 720
NO ./tex/tex_mycel.xpm
SO ./tex/tex_nether_crack.xpm
WE ./tex/tex_stone.xpm
EA ./tex/tex_nether_chisel.xpm

S ./tex/noodle.xpm
F 27,25,24
C 32,0,0

111111111111111111111111111111111111111111111111111111111111111    1111111111111
100000000000000000000000000000000000000000000000000000000000001    1000000000001
100000000000000000000000020000000000000000000000000011110000001    1000000000001
100000000000000000000000000000000000000000000000000001110000001    1000000200001
10001111111110000000000000000000000000000002000000000011000000111111000000000001
10001111111110000000000000111111111000000000000S00000000000000000000000000000001
10201111111110000000000000111111111000000000000000000000000000000000000000000001
10001111111110000000000000000000000000000000000000000000000000111111000000000001
100000000000000000000000000000000000000000000000000000000000001    1000000000001
100000000000000002000000000000020000000000000011110000000000001    1000000000001
102000000000000000000000000000000000000000000011110000000000001    1000000000001
100000000000000000000000000000000000000000000000000000000000001    1000000000001
111111111111111111111111111111111111111111111111111111111111111    1111111111111