R 800 800
NO ./tex_no.xpm
SO ./tex_so.xpm
WE ./tex_we.xpm
EA ./tex_ea.xpm

S ./sprite.xpm
S1 ./sprite2.xpm
S2 ./sprite3.xpm
F 27,25,24
C 110,6,167

1111111111111111111111111111111111111111111111111111111111111111111111111111
1000000000000000000000000000000000000000000000000000000000000000000000000001
1000000000003000000000000000000000000000040000000000000000000000000000000001
1000000000000000000000000000000000000000000000000000000000000000000000000001
11100000000000000000000000000000000000000000000000000000000000000000000000W1
1000000000000000000000000200000000000000000000000000000000000000000000000001
1000000000000000000000000000000000000000000030000000000000000000000000000001
1000000000000000000000000030000000000000000000000000000000000000000000000001
1000000000000000000000000000000000000011111111111111000000000000000000000001
1000000000000000000000000000000000000000000000000000000000000000000000000001
1000000000000000000000000000000000000000000000000000000000000000000000000001
1000000000000000000000000000000000000000000000000000000000000000000000000001
1000000000000000000000111111111100000000000000000000000000000000000000000001
1000000000000000000000000000000000000000000000000000000000000000000000000001
1000000000000000000000000000000000000000000000000000000000000000000000000001
1000000000000000000000002000000000000000000000000000000000000000000000000001
1000000000000000000000000000000000000000000000000000000000000000000000000001
1000000000000000000000000000111110000000000000000000000003000000000000000001
1000000000000000000000000000000000000000000000000000000000000000000000000001
1000000000000000000000000000000000000000000000000000000000000000000000000001
1000000000000000000000000000000000000000000000000000000000000000000000000001
1111111111111111111111111111111111111111111111111111111111111111111111111111