R 800 600 
NO ./texture_no
SO ./texture_so
WE ./texture_we
EA ./texture_ea

S ./sprite
F 220,100,0
C 225,30,0

1111111111111111111111111111111111111111111111
1000000000000000000000000000000000000000000001
1010011111100000000000000000000000000000000001
1000011111100000000000000000000001111000000001
1000000000000000000000000000000001111000000001
1000000000000000000000000000000001111000000001
1000000000000000000001111100000001111000000001
1000000000000000000001111100000000000000000001
1000000000000000000001111100000000000000000001
1000000000000000000000000000000000000000000001
1000111001110000000000000000000000000000000001
1000111001110000000000001001000000000000000001
1000111001110000000000100100010010000000000001
1000000000000000000000000001000000000000000001
1000000000000000000000100000000010000000000001
1000000000000000000000100001000010000000000001
1000000000000000000000000000000000000000000001
1111111111111111111111111111111111111111111111
