R 800 800
NO ./tex_no.xpm
SO ./tex_so.xpm
WE ./tex_we.xpm
EA ./tex_ea.xpm

S ./sprite
F 220,100,0
C 225,30,0

11111111111111111111111111111111111111111111111111111111111111111111111111111111111111
10000000000000001000000000000000010001000000000000100010000000000000010000000000000001
10000000000000001000000000000000010001000010000000100010000000000000010000000000000001
10000000000000001000000000000000010001000010000E00100010000000000000010000000000000001
10000000000000001000000000000000010001000010000000100010000000000000010000000000000001
11111111111111111111100111111111111011101111111111110111111001111111110000000000000001
10000100000000000000000000000000000000000000000000000000000000000000010000000000000001
10000000000000000000100000000000000000000000000000000000000000000000000000000000000001
10000100000000000000000000000000000000000000000000000000000000000000010000000000000001
11111111111111001111100111111111111111111111111100111111100111111111111111111111111111
10000000000000001000000000000000000000000000000000000010000000000000010000000000000001
10000000000000001000000000000000000000000000000000000010000000000000010000000000000001
10000000000000001000000000000000000000000000000000000010000000000000010000000000000001
10000000000000001000000000000000000000000000000000000010000000000000010000000000000001
11111000001111111111111111100000111111000001111111111111111000001111110000000000000001
10000000000000000000000000000000000000000000000000000000000000000000000000000000000001
10000000000000000000000000000000000000000000000000000000000000000000000000000000000001
10000000000000000000000000000000000000000000000000000000000000000000000000000000000001
11111111111111111111111111111111111111111111111111111111111111111111111111111111111111
