R 1280 720
NO ./tex_no.xpm
SO ./tex_so.xpm
WE ./tex_we.xpm
EA ./tex_ea.xpm

S ./sprite
F 220,100,0
C 225,30,0

1111111111111111111111111111111111111111111111111111111111111111111111111111111111111
1000000000000000000000000000000000000000000000000000000000000000000000000000000000001
1000011111111111111110011111111111111111111110000111111111111111110000000111111100001
1000011111111111111110011111111111111111111110000111111111111111110000000111111100001
1000000000000000000000N00000000000000000000000000000000000000000000000000111111100001
1000000000000000000000000000000000000000000000000000000000000000000000000111111100001
1000011111111111111110011111111111111111111110000111111111111111110000000111111100001
1000011111111111111110011111111111111111111110000111111111111111110000000111111100001
1000000000000000000000000000000000000000000000000000000000000000000000000000000000001
1000000S00000000000000000000000000000000000000000000000000000000000000000000000000001
1000111111111111111110011111111111111111111111000111111111111111110000000111111100001
1000111111111111111110011111111111111111111111000111111111111111110000000111111100001
1000000000000000000000000000000000000000000000000000000000000000000000000111111100001
1000000000000000000000000000000000000000000000000000000000000000000000000111111100001
1000011111111111111110011111111111111111111111000111111111111111110000000111111100001
1000011111111111111110011111111111111111111111000111111111111111110000000111111100001
1000000000000000000000000000000000000000000000000000000000000000000000000000000000001
1111111111111111111111111111111111111111111111111111111111111111111111111111111111111
