R 1080 720

NO ./tex/basalt_top.xpm
SO ./tex/blackstone.xpm
WE ./tex/bookshelf.xpm
EA ./tex/bricks.xpm

S ./tex/zombie.xpm
C 36,0,0
F 20,20,20

1111111111111111111111111111111111111111111111111111111111111111111111     111111111111111111111111111111111111111111111111
1000000000000000000000011111111111111111111111111111111000000000000001     100000000000000000000000000000000000000000000001
10000S000000000000000001111111111111111111111111111111100000000000000111111100000000000000000000000000000000000000000000001
100000000000000000000000000000000000000000110000000000000000000000000000000000000000000000000000000200000000000000000000001
100000000000000011000000000000000000000000110000000000000000000000000000000000000000000000000000000000000000000000000000001
100000000000000011000000000000000000000000110000000000000000000000000000000000000000000000000000000000000000000000000000001
100000000000000011111111111111111111000000110000000000000000000000000111111100000000000000000000011111111111111111111111111
1000000000000000111111111111111111110000001100000000000000000000000001     10000000000000000000001
1000000000000000110000000000011000000000001100000000000000000000000001     10000000000000000000001
1000000000000000110000020000011000000200001100000000000000000000000001     100000000002000000000011111111111111111111111111
1000000000000000110000000000011000000000001100000000000000000000000001     100000000000000000000000000000000000000000000001
1000000000000000110000000000011000001111111111111111111111110000000001     100000000000000000000000000000000000000000000001
1000000000000000110000000000011000001111111111111111111111110000000001     100000000000000000000000000000000000000000000001
1000000000000000110000000000011000000000001100000000000000000000000001     100000000000000000000011111111111111111111111111
1000000000000000110000000000011000000000001100000000000000000000200001     10000000000000000000001                         
1000000000000000110000000000011000000000000000000000000000000000000001     10000000000000000000001                         
100000000000000011000000000001100000000000000000000000000000000000000111111100000000000000000000011111111111111111111111111
100000000000000011000000000001111111111111111111111111111111000000000000000000000000000000000000000000000000000000000000001
100000000000000011000000000001111111111111111111111111111111000000000000000000000000000000000000000000000000000000000000001
100000000000000000000000000001100000000000000000000000000000000000000000000000000000000000000000000000000000000002000000001
100000000000000000000000000000000000000000000000000000000000000000000111111100000000000000000000000000000000000000000000001
1000000000000000000000000000000000000000000000000000000000000000000001     100000000000000000000000000000000000000000000001
1111111111111111111111111111111111111111111111111111111111111111111111     111111111111111111111111111111111111111111111111